1111111111111111
1000000000000001
1011111111011101
1000000001000001
1111111111111111
1000000000000001
1011111111111101
1000000000000001
1111111111111111
1000000000000001
1001111111111101
1000000000000001
1111111111111111
