1111111111111111
1000000000000001
1001111010000001
1000001010000001
1000111111110001
1000110000010001
1000111111010001
1000000000010001
1000111111110001
1000000000000001
1111111111111111
1111111111111111
